11111111
100E00001
1P00C0X01
111111111