111111111111111111111111
1C0011110000111110000001
1E0011011001100011000001
100011001100100110000001
100111111100001100000001
1P0011000000010000000001
100011000000111110000001
111111111111111111111111