111111111
100E00001
100000001
100P00001
111111111