1111111
1010011
101X011
1010011
1PEC011
1111111
