111111111111111111111111111111
10C0010000011000000000000CC001
100001000001100000110000011001
100001000001100000110000011001
1P0C01000001100000110000011001
100000000001100E00110000011001
100000000001100000110000011001
100001000001100000110000011001
100001000001100000110000011001
10000000000CC00000CC00000CC001
111111111111111111111111111111
