1111111111
100C001001
10000010E1
1PC0001001
1111111111
