11111111
1E000001
10100101
10100101
1P000101
10100101
10100101
10100101
10100101
10100101
10100101
10100101
10C00C01
10100101
10000001
10000001
10000001
10000001
10000001
10000001
10000001
10000001
10000001
10000001
10000001
10100101
10100101
10100101
10100101
10100101
10100101
10100101
10100101
10100101
10100101
10100101
10100101
10100101
10100101
10100101
10100101
11111111