111111111
100E00101
1000001C1
1PC000101
111111111