1111111
10C0011
1010011
1010011
1PEC011
1010011
1010011
1010011
1010011
1010011
1010011
1010011
1010011
1010011
1010011
1000011
1111111