11111111
100e0001
1p0000x1
11111111