111111111
100EE0001
100000001
1PC000001
111111111