11111111
100E000E
1P000001
11111111