11111111
100E000E
1P00X0C1
11111111