11111111
100e000x
1p000001
11111111