11111111
100E0001
1P00C011
10001001
11111111