111111111
100P00001
100000001
10C000001
111111111