111111111
10PE00001
1000000C1
10P000001
111111111