11111111
100e00001
1p0000x01
11111111