1111111
1000011
1010011
1010011
1PEC011
1111111
