1111111
1000011
1000011
10E0011
1P0C011
1111111
